{
    "start_tiles" : [
        [
            [0, 0],
            [0, 1],
            [1, 0]
        ]
        ,
        [
            [10, 10],
            [10, 9],
            [9, 10]
        ]
    ],
        "data" :
    [[2, 2, 4, 2, 1, 1, 1, 1, 1, 1, 1],
    [2, 8, 2, 2, 2, 4, 2, 4, 2, 4, 1],
    [4, 2, 4, 4, 2, 2, 2, 2, 8, 2, 1],
    [2, 2, 4, 2, 2, 4, 4, 4, 2, 4, 1],
    [1, 2, 2, 2, 8, 2, 2, 4, 2, 2, 1],
    [1, 4, 2, 4, 2, 2, 2, 4, 2, 4, 1],
    [1, 2, 2, 4, 2, 2, 8, 2, 2, 2, 1],
    [1, 4, 2, 4, 4, 4, 2, 2, 4, 2, 2],
    [1, 2, 8, 2, 2, 2, 2, 4, 4, 2, 4],
    [1, 4, 2, 4, 2, 4, 2, 2, 2, 8, 2],
    [1, 1, 1, 1, 1, 1, 1, 2, 4, 2, 2]]

}